#####################################
#       .                           #
#     #########################     #
#                               .   #
#            ..                     #
#     ####       ###########        #
#        #       #                  #
#    .   #   .   #          .       #
#                                   #
#####################################